00 01 02 00 01 02 00 01 02 00 01 02 00 01 02 00 16 17 18 19
01 02 00 01 02 00 01 02 00 01 02 00 01 02 00 01 20 21 23 22
02 00 11 04 04 04 04 04 04 04 04 04 04 05 01 02 25 26 27 28
00 01 10 03 03 03 03 03 03 03 03 03 03 06 02 00 29 24 22 11
01 02 10 03 08 08 08 08 08 08 08 03 03 06 00 01 12 13 13 14
02 00 10 06 00 01 02 00 01 02 00 10 03 06 01 02 15 16 17 18
00 01 10 06 01 11 05 01 02 00 01 10 03 06 02 00 11 21 25 23
01 02 10 06 02 09 07 02 00 01 02 10 03 06 00 01 09 04 05 06
02 00 10 06 00 01 02 00 01 02 00 10 03 06 01 02 03 01 00 02
00 01 10 03 04 04 04 05 02 00 01 09 08 07 02 00 03 03 04 06
01 02 09 08 08 08 08 07 00 01 02 00 01 02 00 01 10 16 17 15
02 00 01 02 00 01 02 00 01 02 00 01 02 00 01 02 14 16 18 19
